50
20
water,590,up

11111111000
00000000000
00000000011
00000000110
01111111130
00000000000
