50
20


20000000000
00000000000
00111011210
00100000200
01200000210
11200000231
