50
20


10101101111
01010102211
10101100000
11400100000
22200100111
00000102222
