250
20
water,610,up

11111010100
11000101000
10100001100
00031003100
01100000000
00001310000
