50
200

LEVEL_HINT_3
00000000000
00000010000
00001111100
22111111111
00000000000
00000000000
