PlayerX=250
PlayerY=20
MAP
00021112000
00021122000
00121122100
01100002110
11100002111
30222000000
