PlayerX=350
PlayerY=20
MAP
00000200000
00000200000
00000200000
00110201100
01111211110
11111213111
