PlayerX=350
PlayerY=20
MAP
00000000000
00000000000
01100100110
11111111111
00011011000
00000000000
