PlayerX=40
PlayerY=20
MAP
00000210200
00100211200
10110222200
01000000000
00000000001
10002222213
