50
20
water,430,down

00000000000
11100000000
00001111000
00011000100
00100000010
11101000131
