350
20


00000000000
00000000000
00000200000
00111211100
01112221110
11122222111
