50
200

LEVEL_HINT_4
00000000011
00000000000
00000000000
00000000000
00000011100
22300023200
