PlayerX=50
PlayerY=20
MAP
00000000000
20100000200
00111111200
00000000200
00000000210
11311111211
