PlayerX=50
PlayerY=20
MAP
00000000000
10000000001
11010101011
11100000111
00000000000
00000000000
