50
20
water,400,down

10100000000
00001001000
00000000010
00000101000
00111010101
00000000000
