40
20


00000000000
10000100001
10001000100
10010010010
10101010101
11111131111
