50
200

LEVEL_HINT_1
00000000000
00000000000
22211111222
00211111200
00222222200
00000000000
