50
20


11111100000
10000100000
11000100011
11200100150
11211100222
22221100000
